000001111111000000
000011000001100000
000110000000110000
001100000000011000
001000000000001000
001000000000001000
001000000000001000
001000000000001000
001000000000001000
001000000000001000
001100000000011000
000110000000110000
000011000001100000
000001111111000000